EA ./textures/norminet/east.xpm
WE ./textures/norminet/north.xpm
NO ./textures/norminet/west.xpm
SO ./textures/cat_big/south_big.xpm
C 255, 186, 8
F 50, 1, 19
111111111111111
100001111011001
100000E00110001
100000000110001
100000000000001
111111111111111