EA ./texture/shrek/shrek2.xpm
WE ./texture/shrek/shrek3.xpm
NO ./texture/shrek/shrek1.xpm
SO ./texture/shrek/shrek4.xpm
C 255, 186, 8
F 50, 1, 19

111111111111111
100001111111001
100000S00110001
100000000110001
100000000000001
111111111111111