NO ./texture/shrek/shrek1.xpm
EA ./texture/shrek/shrek2.xpm
WE ./texture/shrek/shrek3.xpm
SO ./texture/shrek/shrek4.xpm

C 255,186,8
F 50,1,19

111111111111111111                                     
1000000000000000011111111111111111111111111111111111111
1000000000000000000000000000000000000000000000000000001
1000000S00000000011111111111111111111111111111100000001
100000000000000001                            100000001
111111111111111111                            110000001
                                              111111111