NO ./texture/shrek/shrek1.xpm
EA ./texture/shrek/shrek2.xpm
WE ./texture/shrek/shrek3.xpm
SO ./texture/shrek/shrek4.xpm

C 255,186,8
F 50,1,19
1111111111111111111111111111
11111111111S1111111111111111
1111111111111111111111111111